5
5
3
15
1
1
-90
1,1,1,1,1 
1,0,0,2,1
1,0,1,0,1
1,2,0,2,1
1,1,1,1,1