11
11
1
60
5
5
0
1,1,1,1,1,1,1,1,1,1,1
1,1,1,1,1,2,1,1,1,1,1 
1,1,1,1,1,0,1,1,1,1,1 
1,1,1,1,1,0,1,1,1,1,1 
1,1,1,1,0,0,0,1,1,1,1 
1,0,0,0,0,0,0,0,0,0,1 
1,1,1,1,0,0,0,1,1,1,1 
1,1,1,1,1,0,1,1,1,1,1 
1,1,1,1,1,0,1,1,1,1,1 
1,1,1,1,1,9,1,1,1,1,1 
1,1,1,1,1,1,1,1,1,1,1 