15
15
6
120
13
10
180
1,1,1,1,1,1,1,1,1,1,1,1,1,1,1
1,1,1,1,2,0,0,1,0,1,1,1,1,1,1
1,2,1,1,1,1,0,1,0,0,0,0,0,0,1 
1,0,1,0,0,1,0,1,1,1,1,1,1,0,1
1,0,1,0,1,1,0,1,0,0,0,0,0,0,1
1,0,0,0,0,0,0,0,0,1,1,1,1,1,1
1,0,1,0,1,0,2,0,1,1,0,0,0,2,1
1,0,1,0,1,0,0,1,1,1,0,1,1,0,1
1,1,0,0,0,0,0,0,0,0,0,0,0,0,1
1,0,0,1,1,1,0,1,0,0,0,1,1,1,1
1,0,1,0,0,0,0,1,0,1,0,1,1,0,1
1,1,0,0,1,1,1,1,0,1,0,0,0,0,1
1,2,0,1,1,1,1,0,0,2,1,1,1,1,1
1,1,1,1,1,1,1,1,0,1,1,1,1,1,1
1,1,1,1,1,1,1,1,1,1,1,1,1,1,1